id: oficina-vanguardista
title: Oficina vanguardista
biome: Interior
description: Planta abierta con espacios de colaboración y vegetación interior.
dimensions: 20x16
starting_point: 10x12
border colour: #455A64
door in: 2x8 -> comunidad-inicial
door out: 1x8 -> comunidad-inicial@20x14

[tiles]
. = piso; name=Tarima de roble; color=#d7b89c; transparent=true
# = muro; name=Muro estructural; color=#37474f; collides=true
, = alfombra; name=Alfombra acústica; color=#546e7a; transparent=true
~ = cristal; name=Ventanal panorámico; color=#90caf9; transparent=true

[layer estructura]
order: 0
####################
#~~~~~~~~~~~~~~~~~~#
#~~~~~~~~~~~~~~~~~~#
#..................#
#..................#
#..................#
#..................#
#..................#
#..................#
#..................#
#..................#
#..................#
#..................#
#..................#
#..................#
####################

[layer alfombra]
order: 1
####################
#~~~~~~~~~~~~~~~~~~#
#~~~~~~~~~~~~~~~~~~#
#,,,,,,,,,,,,,,,,,,#
#,,,,,,,,,,,,,,,,,,#
#,,,,,,,,,,,,,,,,,,#
#,,,,,,,,,,,,,,,,,,#
#,,,,,,,,,,,,,,,,,,#
#,,,,,,,,,,,,,,,,,,#
#,,,,,,,,,,,,,,,,,,#
#,,,,,,,,,,,,,,,,,,#
#,,,,,,,,,,,,,,,,,,#
#,,,,,,,,,,,,,,,,,,#
#,,,,,,,,,,,,,,,,,,#
#,,,,,,,,,,,,,,,,,,#
####################

[layer pasillos]
order: 2
####################
#~~~~~~~~~~~~~~~~~~#
#~~~~~~~~~~~~~~~~~~#
#.....,,,,,,,,.....#
#.....,,,,,,,,.....#
#.....,,,,,,,,.....#
#.....,,,,,,,,.....#
#.....,,,,,,,,.....#
#.....,,,,,,,,.....#
#.....,,,,,,,,.....#
#.....,,,,,,,,.....#
#.....,,,,,,,,.....#
#.....,,,,,,,,.....#
#.....,,,,,,,,.....#
#.....,,,,,,,,.....#
####################

[objects]
!wall_modern_partition@5x5 | Panel divisor A
!wall_modern_partition@14x5 | Panel divisor B
plant_atrium_totem@17x10 | Totem vegetal central
door_glass_arc@2x8 | Acceso acristalado

[objects_mobiliario]
order: 5
visible: true
table_collaborative_island@8x9 | Mesa de co-creación
table_collaborative_island@11x12 | Mesa de seguimiento
